111111111111
111110000001
111100011001
130101011011
100002001011
100101000011
111104011211
111111111001
111103000001
111111111111
111111111111
111111111111
