111111111111
111110000001
111100011001
111101011011
100002001211
100101000011
111100011211
111111111001
111100000001
111111111111
111111111111
111111111111
