111111111111
111110000001
111100011001
120101011011
100002001011
100101000011
111100011011
111111111001
111120000001
111111111111
111111111111
111111111111
